H H H H H H H H H H H H H H H H H H H H
H P _ H _ _ H _ _ H _ _ H _ ! H _ _ H H
H _ _ Y _ _ B _ _ H _ _ R _ _ G _ _ H H
H y _ H _ _ H _ ! H b _ H _ _ H _ _ H H
H H H H _ _ H H H H H H H _ _ H H H H H
H _ _ H _ _ H _ _ H _ _ H _ _ H _ _ H H
H _ _ Y _ ! B _ _ H _ _ R _ _ G _ _ H H
H _ _ H _ _ H _ _ H _ _ H _ _ H _ _ H H
H H H H _ _ H H H H H H H _ _ H H H H H
H _ _ H _ _ H _ _ H _ _ H _ _ H _ r H H
H _ _ Y _ _ B _ _ H _ _ R _ _ G _ _ H H
H _ _ H _ _ H _ _ H _ _ H _ _ H _ ! H H
H H H H _ _ H H H H H H H _ _ H H H H H
H g _ Y _ _ H ! _ H _ _ H _ _ H H H H H
H _ _ H _ _ _ _ _ _ _ _ _ _ _ B _ _ _ H
H H H H H H H H H H H H H H H H H H f H